1	1	1	1	1	1	1
1	1	1	1	1	1	1
1	2	0	3	0	2	1
1	2	3	0	3	2	1
1	2	0	0	0	2	1
1	2	34	0	34	2	1
1	24	0	3	0	24	1
14	1	1	14	1	1	14
1	1	1	1	1	1	1