0	0	3	2	3	0	0
0	0	3	2	3	0	0
3	3	3	2	3	3	3
1	1	1	2	1	1	1
2	2	2	2	2	2	2
14	14	14	24	14	14	14
3	3	3	2	3	3	3
0	0	3	2	3	0	0
0	0	3	2	3	0	0