1	1	1	1	1	1	1
1	1	1	1	1	1	1
1	2	35	35	35	2	1
1	2	0	3	0	2	1
1	2	0	3	0	2	1
1	24	0	0	0	24	1
14	2	24	24	24	2	14
1	1	1	1	1	1	1
1	1	1	1	1	1	1