1	1	1	1	1	1	1
1	1	1	1	1	1	1
1	35	0	35	0	35	1
1	3	3	3	3	3	1
1	0	3	3	3	0	1
1	3	34	3	34	3	1
1	34	0	34	0	34	1
14	1	1	1	1	1	14
1	1	1	1	1	1	1