1	1	1	1	1	1	1
1	1	1	1	1	1	1
1	2	2	0	2	2	1
1	2	2	0	2	2	1
1	0	2	0	2	0	1
1	35	0	0	0	35	1
1	34	34	34	34	34	1
14	1	1	1	1	1	14
1	1	1	1	1	1	1