1	1	1	1	1	1	1
1	1	1	1	1	1	1
1	3	0	35	0	3	1
1	0	0	3	0	0	1
1	35	3	3	3	35	1
1	0	0	3	0	0	1
1	3	0	35	0	3	1
1	1	14	14	14	1	1
1	1	1	1	1	1	1