1	1	1	1	1	1	1
1	1	1	1	1	1	1
1	2	2	2	2	2	1
1	2	0	0	0	2	1
1	2	0	3	0	2	1
1	2	0	3	0	2	1
1	2	0	3	0	2	1
1	24	34	34	34	24	1
1	1	1	1	1	1	1