1	1	1	1	1	1	1
1	2	3	0	3	2	1
1	2	3	3	3	2	1
1	2	0	0	0	2	1
1	2	15	15	15	2	1
1	2	0	0	0	2	1
1	2	3	34	3	2	1
1	24	34	0	34	24	1
1	1	1	1	1	1	1