1	1	1	1	1	1	1
1	25	25	25	25	25	1
1	2	0	0	0	2	1
1	2	0	3	3	2	1
1	2	0	0	0	2	1
1	2	3	3	0	2	1
1	2	0	0	0	2	1
1	24	24	24	24	24	1
1	1	1	1	1	1	1