1	1	1	1	1	1	1
1	1	1	1	1	1	1
1	0	2	2	2	0	1
1	3	0	2	0	3	1
1	3	3	2	3	3	1
1	34	0	24	0	34	1
14	0	24	2	24	0	14
1	1	1	1	1	1	1
1	1	1	1	1	1	1