1	1	1	1	1	1	1
1	1	1	1	1	1	1
1	25	25	25	25	25	1
1	0	3	0	0	0	1
1	0	3	0	3	0	1
1	0	0	0	3	0	1
1	24	24	24	24	24	1
1	1	1	1	1	1	1
1	1	1	1	1	1	1