1	1	1	1	1	1	1
1	1	1	1	1	1	1
1	25	0	35	0	25	1
1	2	0	3	0	2	1
1	2	0	3	0	2	1
1	2	0	3	0	2	1
1	24	0	3	0	24	1
14	1	14	1	14	1	14
1	1	1	1	1	1	1