1	1	1	1	1	1	1
1	1	1	1	25	0	25
1	1	1	1	24	0	24
1	1	35	1	35	1	1
1	1	3	0	3	1	1
1	1	34	0	34	1	1
25	0	25	1	1	1	1
24	0	24	1	1	1	1
1	1	1	1	1	1	1