0	3	1	1	1	3	0
35	0	3	1	3	0	35
1	35	0	3	0	35	1
1	1	35	25	35	1	1
1	1	2	2	2	1	1
1	1	35	24	35	1	1
1	35	0	3	0	35	1
35	0	3	1	3	0	35
0	3	1	1	1	3	0