1	1	1	1	1	1	1
1	1	1	1	1	1	1
1	3	0	0	3	3	1
1	3	35	35	35	0	1
1	0	35	35	35	0	1
1	0	35	35	35	3	1
1	3	3	0	0	3	1
14	14	14	14	14	14	14
1	1	1	1	1	1	1