0	0	3	3	3	0	0
0	3	1	1	1	3	0
3	2	2	2	2	2	3
1	2	3	0	3	2	1
1	2	0	0	0	2	1
1	2	34	0	34	2	1
34	2	2	24	2	2	34
0	34	1	1	1	34	0
0	0	3	3	3	0	0