0	0	1	1	1	0	0
0	1	1	1	1	1	0
0	2	2	2	2	2	0
2	35	35	35	35	35	2
2	35	0	0	0	35	2
2	35	35	35	35	35	2
0	2	2	2	2	2	0
0	1	1	1	1	1	0
0	0	1	1	1	0	0