1	1	1	1	1	1	1
1	1	34	34	34	1	1
1	1	0	0	0	1	1
1	1	34	34	34	1	1
1	1	0	0	0	1	1
1	1	34	34	34	1	1
1	1	0	0	0	1	1
1	1	1	1	1	1	1
1	1	1	1	1	1	1