1	1	1	34	1	1	1
1	1	0	34	1	1	1
1	0	0	0	1	1	1
1	3	0	34	3	3	1
1	3	0	34	3	3	1
1	3	3	34	0	3	1
1	1	1	0	0	0	1
1	1	1	34	0	1	1
1	1	1	34	0	1	1