1	1	1	1	1	1	1
1	1	1	1	1	1	1
35	1	1	1	1	1	35
34	35	1	1	1	35	34
35	34	35	1	35	34	35
34	35	34	35	34	35	34
1	34	35	34	35	34	1
1	1	34	35	34	1	1
1	1	1	34	1	1	1