1	1	1	1	1	1	1
1	1	1	35	1	1	1
1	1	35	0	35	1	1
1	35	0	0	0	35	1
1	0	0	35	0	0	1
1	0	35	3	35	0	1
34	35	3	3	3	35	34
1	1	1	1	1	1	1
1	1	1	1	1	1	1