1	1	1	35	1	1	1
1	1	35	0	35	1	1
1	35	0	0	0	35	1
35	0	35	0	35	0	35
0	35	35	0	35	35	0
35	1	35	0	35	1	35
1	1	35	0	35	1	1
1	1	35	0	35	1	1
1	1	1	1	1	1	1