1	1	1	1	1	1	1
1	1	1	1	1	1	1
1	34	34	34	34	34	1
1	34	35	35	35	34	1
1	34	35	0	35	34	1
1	34	35	35	35	34	1
1	34	34	34	34	34	1
1	1	1	1	1	1	1
1	1	1	1	1	1	1