1	1	1	1	1	1	1
2	2	2	2	2	2	2
2	3	3	3	3	3	2
2	0	0	3	0	0	2
2	3	0	0	0	3	2
2	3	0	0	0	3	2
24	3	34	3	34	3	24
2	24	2	24	2	24	2
1	1	1	1	1	1	1