1	1	1	1	1	1	1
2	2	2	2	2	2	2
2	3	0	0	0	0	2
2	3	35	35	35	0	2
2	3	0	0	0	0	2
2	3	35	35	35	0	2
2	3	0	0	0	0	2
2	2	2	2	2	2	2
1	1	1	1	1	1	1