1	1	1	1	1	1	1
1	1	1	1	1	1	1
15	15	15	15	15	15	15
0	0	0	0	0	0	0
3	3	3	0	3	3	3
0	0	0	0	0	0	0
15	15	15	15	15	15	15
1	1	1	1	1	1	1
1	1	1	1	1	1	1