0	3	0	0	0	3	0
0	3	2	2	2	3	0
0	3	2	2	2	3	0
3	3	3	3	3	3	3
0	0	24	24	24	0	0
3	3	3	3	3	3	3
0	3	2	2	2	3	0
0	3	2	2	2	3	0
0	3	0	0	0	3	0