35	0	35	0	35	0	35
1	1	1	1	1	1	1
1	34	1	34	1	34	1
1	0	1	0	1	0	1
1	34	1	34	1	34	1
1	0	1	0	1	0	1
1	34	1	34	1	34	1
1	1	1	1	1	1	1
35	0	35	0	35	0	35