1	3	3	0	3	3	1
1	3	3	0	0	0	1
1	3	3	0	35	35	1
1	0	0	0	35	35	1
1	35	35	0	35	35	1
1	35	35	0	0	0	1
1	35	35	0	3	3	1
1	0	0	0	3	3	1
1	3	3	0	3	3	1