1	1	1	1	1	1	1
1	2	2	0	0	0	1
1	2	35	35	35	0	1
1	2	35	0	35	0	1
1	0	35	0	35	2	1
1	0	35	35	35	2	1
1	0	0	0	2	2	1
1	1	1	1	1	1	1
1	1	1	1	1	1	1