2	2	2	2	2	2	2
2	0	0	0	0	0	2
2	0	35	35	35	0	2
2	3	35	0	35	3	2
2	0	35	35	35	0	2
2	0	0	0	0	0	2
2	2	2	2	2	2	2
1	1	1	1	1	1	1
1	1	1	1	1	1	1