1	1	1	1	1	1	1
1	0	1	1	1	0	1
1	0	35	35	35	0	1
1	0	35	0	35	0	1
1	34	35	0	35	34	1
1	0	35	0	35	0	1
1	0	35	35	35	0	1
1	0	1	1	1	0	1
1	1	1	1	1	1	1