1	1	1	1	1	1	1
1	1	1	1	1	1	1
1	1	0	1	1	1	1
0	0	0	1	1	1	1
35	35	0	1	0	1	1
1	0	0	0	0	1	1
1	35	35	35	0	1	0
1	1	1	0	0	0	0
1	1	1	35	35	35	0