2	2	2	2	2	2	2
0	0	3	0	3	0	0
35	0	3	3	3	0	35
35	0	0	0	0	0	35
35	35	35	35	35	35	35
2	2	2	2	2	2	2
1	1	1	1	1	1	1
1	1	1	1	1	1	1
1	1	1	1	1	1	1