0	0	0	0	3	3	3
3	3	3	0	0	0	0
0	0	0	0	3	3	3
3	3	3	0	0	0	0
0	0	0	0	3	3	3
35	35	35	35	35	35	35
1	1	1	1	1	1	1
1	1	1	1	1	1	1
1	1	1	1	1	1	1